.                  .
.                  .
.M+           +    .
.::          :::   .
...     +          .
     ::::::        .
                 ::.
                   .
:       #     +    .
.  ::::::::oo:::ooo.
.     .            .
.    l.d           .
.   ::.::        ::.
.F  .....      ::...
.:::.....::::::.....
....................