-B       --        -
-        --        -
-    + M -- F +    -
-   =====--=====   -
-        --        -
-        --        -
-  #     --    #   -
-=====   --   =====-
-        --        -
-        --        -
-      + --l+      -
-ooo=====--=====ooo-
-                  -
-                 d-
-=======###========-
--------------------
