-                  -
-M                 -
-==    +    +      -
---   ooooo====  + -
-                ==-
-                  -
-d                 -
-==########=====   -
---========-       -
-                  -
-         +        -
-l      ====       -
-==     ----       -
---=    ----   +  F-
--------------------
