.                  .
.                  .
.M     +      +    .
.:::  :::::  ::oooo.
.              o   .
.              o f .
.              oooo.
.  :::::  :::::o   .
.              o   .
.l             o   .
.::            o   .
...::  ::::    o  d.
.....  ....    oo::.
.....##....    oo...
...........::::::...
....................