                    
                    
                    
                    
*                  *
_                  _
_                  _
_                 d_
_               ***_
_ M         +   ____
_******  *******____
_______##___________
____________________
____________________
____________________
____________________