.               o  .
.               o  .
.    M +     +  o d.
.   ::oo::  :::::::.
.:            o    .
..:           o +  .
...:          o + f.
....:      oooooooo.
.....              .
.....:::           .
........:::::::    .
.                 :.
.                 ..
.l              + ..
.:::##::::::::::::..
....................