B                   
                    
=                   
-                   
-M+                =
-==    +           -
-    ===    +      -
-         ===      -
-               +  -
-              ==  -
-                  -
-                  -
-F                d-
-===###==###==###==-
--------------------
