-        B          
-M                  
-==   +  +          
-    ======        =
-                  -
-               +  -
-===     ==oooooooo-
-       =--        -
-     ==---d##     -
-     -----=====   -
-                 =-
-l                --
-==              =--
---        +    F---
---==============---
--------------------